4 1 1 1 1 1 1 1 1 1 1 1 1 1 1 1 1 1 1 4
0 0 0 0 0 0 1 0 0 0 0 0 1 0 0 0 0 0 0 0
0 0 0 0 0 0 1 0 0 0 0 0 1 0 0 0 0 0 0 0
0 0 0 0 0 0 3 0 0 0 0 0 1 0 0 0 0 1 1 4
0 0 0 0 0 0 1 0 0 0 0 0 1 1 1 1 1 1 0 0
4 1 1 1 1 1 1 0 0 0 0 0 1 0 0 0 0 0 0 0
0 0 0 0 0 0 1 0 0 0 0 0 1 0 0 0 0 0 0 0
0 0 0 0 0 0 1 0 0 0 0 0 1 0 0 0 0 0 0 0
0 0 0 0 0 0 1 0 0 0 0 0 1 0 0 0 0 0 0 0
0 0 0 0 0 0 4 0 0 0 0 0 4 0 0 0 0 0 0 0
地图二维数组(0 : 空地,1:路,2:塔(请勿自定义设置),3:起点,4:终点)
